#Author: Comereal
3 5 562 1644 1227 1224 576
2 5 576 574 522 589 587
1 2 1644 1100
1 2 1100 1227
3 11 562 563 1153 1718 1683 849 1277 1276 1278 1545 1542
2 7 562 564 1383 617 1040 1038 1042
2 11 1038 1039 1739 1742 1744 536 537 1298 1296 1029 1027
2 7 1027 1154 731 729 815 814 515
1 5 1742 802 799 1763 1759
1 7 1154 1696 635 1266 1267 1521 1109